\minus	minus	LucidNewMatSymT
\periodcentered	periodcentered	LucidNewMatSymT
\multiply	multiply	LucidNewMatSymT
\asteriskmath	asteriskmath	LucidNewMatSymT
\divide	divide	LucidNewMatSymT
\diamondmath	diamondmath	LucidNewMatSymT
\plusminus	plusminus	LucidNewMatSymT
\minusplus	minusplus	LucidNewMatSymT
\circleplus	circleplus	LucidNewMatSymT
\circleminus	circleminus	LucidNewMatSymT
\circlemultiply	circlemultiply	LucidNewMatSymT
\circledivide	circledivide	LucidNewMatSymT
\circledot	circledot	LucidNewMatSymT
\circlecopyrt	circlecopyrt	LucidNewMatSymT
\openbullet	openbullet	LucidNewMatSymT
\bullet	bullet	LucidNewMatSymT
\equivasymptotic	equivasymptotic	LucidNewMatSymT
\equivalence	equivalence	LucidNewMatSymT
\reflexsubset	reflexsubset	LucidNewMatSymT
\reflexsuperset	reflexsuperset	LucidNewMatSymT
\lessequal	lessequal	LucidNewMatSymT
\greaterequal	greaterequal	LucidNewMatSymT
\precedesequal	precedesequal	LucidNewMatSymT
\followsequal	followsequal	LucidNewMatSymT
\similar	similar	LucidNewMatSymT
\approxequal	approxequal	LucidNewMatSymT
\propersubset	propersubset	LucidNewMatSymT
\propersuperset	propersuperset	LucidNewMatSymT
\lessmuch	lessmuch	LucidNewMatSymT
\greatermuch	greatermuch	LucidNewMatSymT
\precedes	precedes	LucidNewMatSymT
\follows	follows	LucidNewMatSymT
\arrowleft	arrowleft	LucidNewMatSymT
\spade	spade	LucidNewMatSymT
\arrowright	arrowright	LucidNewMatSymT
\arrowup	arrowup	LucidNewMatSymT
\arrowdown	arrowdown	LucidNewMatSymT
\arrowboth	arrowboth	LucidNewMatSymT
\arrownortheast	arrownortheast	LucidNewMatSymT
\arrowsoutheast	arrowsoutheast	LucidNewMatSymT
\similarequal	similarequal	LucidNewMatSymT
\arrowdblleft	arrowdblleft	LucidNewMatSymT
\arrowdblright	arrowdblright	LucidNewMatSymT
\arrowdblup	arrowdblup	LucidNewMatSymT
\arrowdbldown	arrowdbldown	LucidNewMatSymT
\arrowdblboth	arrowdblboth	LucidNewMatSymT
\arrownorthwest	arrownorthwest	LucidNewMatSymT
\arrowsouthwest	arrowsouthwest	LucidNewMatSymT
\proportional	proportional	LucidNewMatSymT
\prime	prime	LucidNewMatSymT
\infinity	infinity	LucidNewMatSymT
\element	element	LucidNewMatSymT
\owner	owner	LucidNewMatSymT
\triangle	triangle	LucidNewMatSymT
\triangleinv	triangleinv	LucidNewMatSymT
\negationslash	negationslash	LucidNewMatSymT
\mapsto	mapsto	LucidNewMatSymT
\universal	universal	LucidNewMatSymT
\existential	existential	LucidNewMatSymT
\logicalnot	logicalnot	LucidNewMatSymT
\emptyset	emptyset	LucidNewMatSymT
\Rfractur	Rfractur	LucidNewMatSymT
\Ifractur	Ifractur	LucidNewMatSymT
\latticetop	latticetop	LucidNewMatSymT
\perpendicular	perpendicular	LucidNewMatSymT
\aleph	aleph	LucidNewMatSymT
\scriptA	scriptA	LucidNewMatSymT
\scriptB	scriptB	LucidNewMatSymT
\scriptC	scriptC	LucidNewMatSymT
\scriptD	scriptD	LucidNewMatSymT
\scriptE	scriptE	LucidNewMatSymT
\scriptF	scriptF	LucidNewMatSymT
\scriptG	scriptG	LucidNewMatSymT
\scriptH	scriptH	LucidNewMatSymT
\scriptI	scriptI	LucidNewMatSymT
\scriptJ	scriptJ	LucidNewMatSymT
\scriptK	scriptK	LucidNewMatSymT
\scriptL	scriptL	LucidNewMatSymT
\scriptM	scriptM	LucidNewMatSymT
\scriptN	scriptN	LucidNewMatSymT
\scriptO	scriptO	LucidNewMatSymT
\scriptP	scriptP	LucidNewMatSymT
\scriptQ	scriptQ	LucidNewMatSymT
\scriptR	scriptR	LucidNewMatSymT
\scriptS	scriptS	LucidNewMatSymT
\scriptT	scriptT	LucidNewMatSymT
\scriptU	scriptU	LucidNewMatSymT
\scriptV	scriptV	LucidNewMatSymT
\scriptW	scriptW	LucidNewMatSymT
\scriptX	scriptX	LucidNewMatSymT
\scriptY	scriptY	LucidNewMatSymT
\scriptZ	scriptZ	LucidNewMatSymT
\union	union	LucidNewMatSymT
\intersection	intersection	LucidNewMatSymT
\unionmulti	unionmulti	LucidNewMatSymT
\logicaland	logicaland	LucidNewMatSymT
\logicalor	logicalor	LucidNewMatSymT
\turnstileleft	turnstileleft	LucidNewMatSymT
\turnstileright	turnstileright	LucidNewMatSymT
\floorleft	floorleft	LucidNewMatSymT
\floorright	floorright	LucidNewMatSymT
\ceilingleft	ceilingleft	LucidNewMatSymT
\ceilingright	ceilingright	LucidNewMatSymT
\braceleft	braceleft	LucidNewMatSymT
\braceright	braceright	LucidNewMatSymT
\angbracketleft	angbracketleft	LucidNewMatSymT
\angbracketright	angbracketright	LucidNewMatSymT
\bar	bar	LucidNewMatSymT
\bardbl	bardbl	LucidNewMatSymT
\arrowbothv	arrowbothv	LucidNewMatSymT
\arrowdblbothv	arrowdblbothv	LucidNewMatSymT
\backslash	backslash	LucidNewMatSymT
\wreathproduct	wreathproduct	LucidNewMatSymT
\radical	radical	LucidNewMatSymT
\coproduct	coproduct	LucidNewMatSymT
\nabla	nabla	LucidNewMatSymT
\integral	integral	LucidNewMatSymT
\unionsq	unionsq	LucidNewMatSymT
\intersectionsq	intersectionsq	LucidNewMatSymT
\subsetsqequal	subsetsqequal	LucidNewMatSymT
\supersetsqequal	supersetsqequal	LucidNewMatSymT
\section	section	LucidNewMatSymT
\dagger	dagger	LucidNewMatSymT
\daggerdbl	daggerdbl	LucidNewMatSymT
\paragraph	paragraph	LucidNewMatSymT
\club	club	LucidNewMatSymT
\diamond	diamond	LucidNewMatSymT
\heart	heart	LucidNewMatSymT
