\Gamma	Gamma	LucidNewMatItaT
\Delta	Delta	LucidNewMatItaT
\Theta	Theta	LucidNewMatItaT
\Lambda	Lambda	LucidNewMatItaT
\Xi	Xi	LucidNewMatItaT
\Pi	Pi	LucidNewMatItaT
\Sigma	Sigma	LucidNewMatItaT
\Upsilon	Upsilon	LucidNewMatItaT
\Phi	Phi	LucidNewMatItaT
\Psi	Psi	LucidNewMatItaT
\Omega	Omega	LucidNewMatItaT
\alpha	alpha	LucidNewMatItaT
\beta	beta	LucidNewMatItaT
\gamma	gamma	LucidNewMatItaT
\delta	delta	LucidNewMatItaT
\epsilon1	epsilon1	LucidNewMatItaT
\zeta	zeta	LucidNewMatItaT
\eta	eta	LucidNewMatItaT
\theta	theta	LucidNewMatItaT
\iota	iota	LucidNewMatItaT
\kappa	kappa	LucidNewMatItaT
\lambda	lambda	LucidNewMatItaT
\mu	mu	LucidNewMatItaT
\nu	nu	LucidNewMatItaT
\xi	xi	LucidNewMatItaT
\pi	pi	LucidNewMatItaT
\rho	rho	LucidNewMatItaT
\sigma	sigma	LucidNewMatItaT
\tau	tau	LucidNewMatItaT
\upsilon	upsilon	LucidNewMatItaT
\phi	phi	LucidNewMatItaT
\chi	chi	LucidNewMatItaT
\psi	psi	LucidNewMatItaT
\tie	tie	LucidNewMatItaT
\omega	omega	LucidNewMatItaT
\epsilon	epsilon	LucidNewMatItaT
\theta1	theta1	LucidNewMatItaT
\pi1	pi1	LucidNewMatItaT
\rho1	rho1	LucidNewMatItaT
\sigma1	sigma1	LucidNewMatItaT
\phi1	phi1	LucidNewMatItaT
\arrowlefttophalf	arrowlefttophalf	LucidNewMatItaT
\arrowleftbothalf	arrowleftbothalf	LucidNewMatItaT
\arrowrighttophalf	arrowrighttophalf	LucidNewMatItaT
\arrowrightbothalf	arrowrightbothalf	LucidNewMatItaT
\arrowhookleft	arrowhookleft	LucidNewMatItaT
\arrowhookright	arrowhookright	LucidNewMatItaT
\triangleright	triangleright	LucidNewMatItaT
\triangleleft	triangleleft	LucidNewMatItaT
\period	period	LucidNewMatItaT
\comma	comma	LucidNewMatItaT
\less	less	LucidNewMatItaT
\slash	slash	LucidNewMatItaT
\greater	greater	LucidNewMatItaT
\star	star	LucidNewMatItaT
\partialdiff	partialdiff	LucidNewMatItaT
\flat	flat	LucidNewMatItaT
\natural	natural	LucidNewMatItaT
\sharp	sharp	LucidNewMatItaT
\slurbelow	slurbelow	LucidNewMatItaT
\slurabove	slurabove	LucidNewMatItaT
\lscript	lscript	LucidNewMatItaT
\dotlessi	dotlessi	LucidNewMatItaT
\dotlessj	dotlessj	LucidNewMatItaT
\weierstrass	weierstrass	LucidNewMatItaT
\vector	vector	LucidNewMatItaT
