\parenleftbig	parenleftbig	LucidNewMatExtT\\
\parenrightbig	parenrightbig	LucidNewMatExtT\\
\bracketleftbig	bracketleftbig	LucidNewMatExtT\\
\bracketrightbig	bracketrightbig	LucidNewMatExtT\\
\floorleftbig	floorleftbig	LucidNewMatExtT\\
\floorrightbig	floorrightbig	LucidNewMatExtT\\
\ceilingleftbig	ceilingleftbig	LucidNewMatExtT\\
\ceilingrightbig	ceilingrightbig	LucidNewMatExtT\\
\braceleftbig	braceleftbig	LucidNewMatExtT\\
\bracerightbig	bracerightbig	LucidNewMatExtT\\
\angbracketleftbig	angbracketleftbig	LucidNewMatExtT\\
\angbracketrightbig	angbracketrightbig	LucidNewMatExtT\\
\vextendsingle	vextendsingle	LucidNewMatExtT\\
\vextenddouble	vextenddouble	LucidNewMatExtT\\
\slashbig	slashbig	LucidNewMatExtT\\
\backslashbig	backslashbig	LucidNewMatExtT\\
\parenleftBig	parenleftBig	LucidNewMatExtT\\
\parenrightBig	parenrightBig	LucidNewMatExtT\\
\parenleftbigg	parenleftbigg	LucidNewMatExtT\\
\parenrightbigg	parenrightbigg	LucidNewMatExtT\\
\bracketleftbigg	bracketleftbigg	LucidNewMatExtT\\
\bracketrightbigg	bracketrightbigg	LucidNewMatExtT\\
\floorleftbigg	floorleftbigg	LucidNewMatExtT\\
\floorrightbigg	floorrightbigg	LucidNewMatExtT\\
\ceilingleftbigg	ceilingleftbigg	LucidNewMatExtT\\
\ceilingrightbigg	ceilingrightbigg	LucidNewMatExtT\\
\braceleftbigg	braceleftbigg	LucidNewMatExtT\\
\bracerightbigg	bracerightbigg	LucidNewMatExtT\\
\angbracketleftbigg	angbracketleftbigg	LucidNewMatExtT\\
\angbracketrightbigg	angbracketrightbigg	LucidNewMatExtT\\
\slashbigg	slashbigg	LucidNewMatExtT\\
\backslashbigg	backslashbigg	LucidNewMatExtT\\
\parenleftBigg	parenleftBigg	LucidNewMatExtT\\
\parenrightBigg	parenrightBigg	LucidNewMatExtT\\
\bracketleftBigg	bracketleftBigg	LucidNewMatExtT\\
\bracketrightBigg	bracketrightBigg	LucidNewMatExtT\\
\floorleftBigg	floorleftBigg	LucidNewMatExtT\\
\floorrightBigg	floorrightBigg	LucidNewMatExtT\\
\ceilingleftBigg	ceilingleftBigg	LucidNewMatExtT\\
\ceilingrightBigg	ceilingrightBigg	LucidNewMatExtT\\
\braceleftBigg	braceleftBigg	LucidNewMatExtT\\
\bracerightBigg	bracerightBigg	LucidNewMatExtT\\
\angbracketleftBigg	angbracketleftBigg	LucidNewMatExtT\\
\angbracketrightBigg	angbracketrightBigg	LucidNewMatExtT\\
\slashBigg	slashBigg	LucidNewMatExtT\\
\backslashBigg	backslashBigg	LucidNewMatExtT\\
\slashBig	slashBig	LucidNewMatExtT\\
\backslashBig	backslashBig	LucidNewMatExtT\\
\parenlefttp	parenlefttp	LucidNewMatExtT\\
\parenrighttp	parenrighttp	LucidNewMatExtT\\
\bracketlefttp	bracketlefttp	LucidNewMatExtT\\
\bracketrighttp	bracketrighttp	LucidNewMatExtT\\
\bracketleftbt	bracketleftbt	LucidNewMatExtT\\
\bracketrightbt	bracketrightbt	LucidNewMatExtT\\
\bracketleftex	bracketleftex	LucidNewMatExtT\\
\bracketrightex	bracketrightex	LucidNewMatExtT\\
\bracelefttp	bracelefttp	LucidNewMatExtT\\
\bracerighttp	bracerighttp	LucidNewMatExtT\\
\braceleftbt	braceleftbt	LucidNewMatExtT\\
\bracerightbt	bracerightbt	LucidNewMatExtT\\
\braceleftmid	braceleftmid	LucidNewMatExtT\\
\bracerightmid	bracerightmid	LucidNewMatExtT\\
\braceex	braceex	LucidNewMatExtT\\
\arrowvertex	arrowvertex	LucidNewMatExtT\\
\parenleftbt	parenleftbt	LucidNewMatExtT\\
\parenrightbt	parenrightbt	LucidNewMatExtT\\
\parenleftex	parenleftex	LucidNewMatExtT\\
\parenrightex	parenrightex	LucidNewMatExtT\\
\angbracketleftBig	angbracketleftBig	LucidNewMatExtT\\
\angbracketrightBig	angbracketrightBig	LucidNewMatExtT\\
\unionsqtext	unionsqtext	LucidNewMatExtT\\
\unionsqdisplay	unionsqdisplay	LucidNewMatExtT\\
\contintegraltext	contintegraltext	LucidNewMatExtT\\
\contintegraldisplay	contintegraldisplay	LucidNewMatExtT\\
\circledottext	circledottext	LucidNewMatExtT\\
\circledotdisplay	circledotdisplay	LucidNewMatExtT\\
\circleplustext	circleplustext	LucidNewMatExtT\\
\circleplusdisplay	circleplusdisplay	LucidNewMatExtT\\
\circlemultiplytext	circlemultiplytext	LucidNewMatExtT\\
\circlemultiplydisplay	circlemultiplydisplay	LucidNewMatExtT\\
\summationtext	summationtext	LucidNewMatExtT\\
\producttext	producttext	LucidNewMatExtT\\
\integraltext	integraltext	LucidNewMatExtT\\
\uniontext	uniontext	LucidNewMatExtT\\
\intersectiontext	intersectiontext	LucidNewMatExtT\\
\unionmultitext	unionmultitext	LucidNewMatExtT\\
\logicalandtext	logicalandtext	LucidNewMatExtT\\
\logicalortext	logicalortext	LucidNewMatExtT\\
\summationdisplay	summationdisplay	LucidNewMatExtT\\
\productdisplay	productdisplay	LucidNewMatExtT\\
\integraldisplay	integraldisplay	LucidNewMatExtT\\
\uniondisplay	uniondisplay	LucidNewMatExtT\\
\intersectiondisplay	intersectiondisplay	LucidNewMatExtT\\
\unionmultidisplay	unionmultidisplay	LucidNewMatExtT\\
\logicalanddisplay	logicalanddisplay	LucidNewMatExtT\\
\logicalordisplay	logicalordisplay	LucidNewMatExtT\\
\coproducttext	coproducttext	LucidNewMatExtT\\
\coproductdisplay	coproductdisplay	LucidNewMatExtT\\
\hatwide	hatwide	LucidNewMatExtT\\
\hatwider	hatwider	LucidNewMatExtT\\
\hatwidest	hatwidest	LucidNewMatExtT\\
\tildewide	tildewide	LucidNewMatExtT\\
\tildewider	tildewider	LucidNewMatExtT\\
\tildewidest	tildewidest	LucidNewMatExtT\\
\bracketleftBig	bracketleftBig	LucidNewMatExtT\\
\bracketrightBig	bracketrightBig	LucidNewMatExtT\\
\floorleftBig	floorleftBig	LucidNewMatExtT\\
\floorrightBig	floorrightBig	LucidNewMatExtT\\
\ceilingleftBig	ceilingleftBig	LucidNewMatExtT\\
\ceilingrightBig	ceilingrightBig	LucidNewMatExtT\\
\braceleftBig	braceleftBig	LucidNewMatExtT\\
\bracerightBig	bracerightBig	LucidNewMatExtT\\
\radicalbig	radicalbig	LucidNewMatExtT\\
\radicalBig	radicalBig	LucidNewMatExtT\\
\radicalbigg	radicalbigg	LucidNewMatExtT\\
\radicalBigg	radicalBigg	LucidNewMatExtT\\
\radicalbt	radicalbt	LucidNewMatExtT\\
\radicalvertex	radicalvertex	LucidNewMatExtT\\
\radicaltp	radicaltp	LucidNewMatExtT\\
\arrowvertexdbl	arrowvertexdbl	LucidNewMatExtT\\
\arrowtp	arrowtp	LucidNewMatExtT\\
\arrowbt	arrowbt	LucidNewMatExtT\\
\bracehtipdownleft	bracehtipdownleft	LucidNewMatExtT\\
\bracehtipdownright	bracehtipdownright	LucidNewMatExtT\\
\bracehtipupleft	bracehtipupleft	LucidNewMatExtT\\
\bracehtipupright	bracehtipupright	LucidNewMatExtT\\
\arrowdbltp	arrowdbltp	LucidNewMatExtT\\
\arrowdblbt	arrowdblbt	LucidNewMatExtT\\
